
Hello	ORG
World	ORG

Qiaotong	PER
Wu	PER
,	O
@Bruce	PER
Jiang	PER
??	O
!!	O
Yews	ORG
New	ORG
York	ORG
University	ORG

FIFA	O
World	O
Cup	O
Los	ORG
Angeles	ORG
New	ORG
York	ORG
#Where	ORG

